0000000000000000000000000
0000000000000000000000000
0000000000000000000000000
0000000000000000000000000
0000000000000000000000000
0000000000000000000000000
0000000000000000000000000
0000000000000000000000000
0000000000000000000000000
0000000000000000000000000
0000000000000000000000000
0000000000000021111300000
0000000000002111366530000
0021300211111136866653000
2111111111111111111111111
7666666666666666666666666
7666666666666666666666666
7666666666666666666666666
7666666666666666666666666
7666666666666666666666666
7666666666666666666666666
7666666666666666666666666