111111111111111111111111111111111111111
100000000000000000000000000000000000001
100000000000000000000000000000000000001
100000000000000000000000000000000000001
100000000000000000000001111000000000001
111111111111110011111111001111111110001
100000000000011110000000000000000000001
100000000000000000000000000000000000001
100000000000000000000000000000000000001
100000000000000000000000000000000000001
100000000010000000000000000000000000001
100011111111111100010001000100011111111
100000000000000111111111111111110000001
100000000000000000000000000000000000001
100000000000000000000000000000000000001
100000000000000000000000000000000110001
100000001000000001111111000000001100001
111111111111111111000001111111111000001
100000000000000000000000000000000000001
100000000000000000000000000000000000001
100000000000000000000000000000000000001
100000000000000000000000000000000000001
100000000000000000000000000000000000001
100000000010000000000000000000000000001
111111111111111111111111111111111111111